!!
부서가 그대로 옮겨 간 것일까?
한 부서에서 다른 부서들로 나눠지는 현상은 없었을까?

오래된 데이터가 많음 ex. 2003년.
행정조직에 변화가 있다. -> 데이터를 하나의 클래스로 합쳐야 함 

'~ 과'에서 처리할 것이다 라는 정보를 제공하기 위해서는
행정조직의 변화와 현재 상태를 알 필요가 있음.

--> 클래스 수가 줄어들고, 데티어가 정제되면서 모델의 성능이 높아질 것으로 예상됨. (같은 내용의 민원이 여러 개의 클래스로 나눠져 있던 현상을 해결)


북구
도시국 도시관리과 -> 도시국 도시행정과
도시국 재난안전과 -> 도시국 도시행정과
주민생활지원국 환경관리과 -> 복지환경국 환경관리과 (쓰레기 관련)

::: 노점상/노상정비 관련 처리부서가   도시국 재난안전과 -> 도시국 도시행정과 로 바뀐 듯함 (노상정비팀 따로 O, 노상적치물 == 노점)

달성군
건설도시국 교통과 -> 경제환경국 교통과
건설도시국 도시정비과 -> 건설도시국 도시계획과


달서구
경제환경국 환경보호과 -> 경제환경국 녹색환경과 -> 경제환경국 환경보호과 -> 경제환경국 기후환경과
도시건설국 도시관리과 -> 도시창조국 도시재생과 -> 도시창조국 도시디자인과
경제환경국 일자리경제과 -> 경제환경국 일자리지원과
보건소 보건과 -> 보건소 보건행정과
복지문화국 문화체육관광과 -> 복지문화국 문화관광과


::: 도시창조국 건설과 - 건물말고, 보도블록, 가로등 등
도시창조국 건축과 - 건물


동구
복지생활국 경제과 -> 경제복지국 경제지원과 -> 경제환경국 민생경제과
주민생활지원국 환경청소과 -> 복지생활국 환경자원과 -> 경제복지국 환경녹색과 -> 경제환경국 환경과
도시건설국 건설과 -> 도시안전국 건설과
도시건설국 건축주택과 -> 도시안전국 교통과
도시건설국 교통과 -> 도시안전국 교통과
도시건설국 도시공원과 -> 도시건설국 안전녹지과 -> 도시안전국 공원녹지과
보건소 보건의약과 -> 보건소 보건행정과
안전행정국 평생학습과 -> 행정문화국 문화체육과 -> 행정문화교육국 체육진흥과
행정문화국 행정지원과 -> 행정문화교육국 행정지원과
도시건설국 도시디자인과 -> 도시안전국 도시과

중구
도시관광국 건설과 -> 환경건설국 건설안전과 -> 도시안전국 건설과
도시관광국 건축주택과 -> 환경건설국 건축주택과 -> 도시안전국 건축주택과
도시국 도시관리과 -> 도시재생국 도시재생과 -> 도시안전국 도시재생과
주민생활지원국 문화관광과 -> 도시재생국 관광자원과 -> 관광경제국 문화교육과
주민생활지원국 환경과 -> 환경건설국 녹색환경과-> 관광경제국 환경자원과
환경건설국 교통과 -> 도시안전국 교통과
총무국 총무과 -> 기획예산실
행정지원국 경제과 -> 안전행정국 경제과 -> 행정지원국 경제과 -> 관광경제국 일자리경제과

남구 
도시국 지역교통과 -> 도시창조국 교통과
보건소 -> 보건소 보건행정과
주민생활지원국 환경관리과 -> 주민생활국 생활환경과 -> 주민행복국 녹색환경과

서구
기획감사실 -> 기획조정실 -> 기획예산실
도시국 건설과 -> 도시국 건설방재과 -> 도시안전국 건설과
도시국 건축주택과 -> 도시안전국 건축주택과
도시국 교통과 -> 도시안전국 교통과
도시국 도시관리과 -> 도시안전국 도시재생과
주민생활지원국 경제과 -> 복지생활국 경제과
사회산업국 사회복지과 -> 주민생활지원국 복지사업과 -> 복지생활국 사회복지과
사회산업국 청소과 -> 주민생활지원국 환경관리과  -> 복지생활국 환경청소과
사회산업국 환경관리과 -> 주민생활지원국 경제과 -> 복지생활국 경제과

수성구
교육문화국 문화체육과 -> 문화교육국 문화예술과+체육진흥과
복지국 경제환경과 -> 복지국 녹색환경과
복지국 복지과 -> 복지국 복지정책과